000000000000000
000000000000000
000000000000000
000001110000000
000000001000000
000000000000000
000000000000000
111100000000111
000000001000001
000000001000001
000000001000001
000000000100001
000000000100001
000000000100001
000000000000000
111000000000000
000000000000000
000000100011000
000000100010000
000000100010000
