000000000000000
000000000000000
000000000010000
000000000010000
000001000010000
000111000010000
000000000000000
000000000000000
000000000000000
000000000000000
010000110000000
000000000000000
000000000000000
000000000000000
000010000111111
000010000000000
000010000000000
000000000000000
000000000000000
000000001000000
